"aa" = (
/turf/open/space/basic,
/area/space),
"ab" = (
/turf/open/floor/plasteel
)
"ac" = (
/turf/debug
)
"ad" = (
/turf/area/nw
)
"ae" = (
/turf/area/ne
)
"af" = (
/turf/open/floor/plasteel,
/obj/machinery/door/airlock/external/glass{
    icon_state = "opening"
}
)
"ah" = (
/turf/open/floor/plasteel,
/obj/effect/turf_decal/stripes/asteroid/line
)

(0,0,1) = {"ac"}
(1,1,1) = {"
ad aa aa aa aa aa aa aa aa ac
"}
(2,1,1) = {"
aa aa ab ab ab ab ab ab ab aa
"}
(3,1,1) = {"
aa aa ab ab af ah ab ab ab aa
"}
(4,1,1) = {"
aa aa ab ab ab ab ab ab ab aa
"}
(5,1,1) = {"
ae aa ab ab ab ab ab ab ab ac
"}
